ipp	ipp
mdns	mdns
netbios	netbios
ssdp	ssdp
xdmcp	xdmcp
postgres	postgres
hotmail	hotmail
directdownload	directdownload
pops	pops
applejuice	applejuice
directconnect	directconnect
socrates	socrates
coap	coap
vmware	vmware
filetopia	filetopia
ubntac2	ubntac2
kontiki	kontiki
openft	openft
fasttrack	fasttrack
gnutella	gnutella
edonkey	edonkey
bittorrent	bittorrent
epp	epp
avi	avi
flash	flash
ogg	ogg
mpeg	mpeg
quicktime	quicktime
realmedia	realmedia
windowsmedia	windowsmedia
xbox	xbox
qq	qq
move	move
icecast	icecast
pplive	pplive
ppstream	ppstream
zattoo	zattoo
shoutcast	shoutcast
sopcast	sopcast
tvants	tvants
tvuplayer	tvuplayer
http_download	http_download
qqlive	qqlive
thunder	thunder
soulseek	soulseek
ssl_no_cert	ssl_no_cert
ayiya	ayiya
unencryped_jabber	unencryped_jabber
oscar	oscar
yahoo	yahoo
battlefield	battlefield
vrrp	vrrp
steam	steam
halflife2	halflife2
worldofwarcraft	worldofwarcraft
stun	stun
ipsec	ipsec
igmp	igmp
egp	egp
sctp	sctp
ipip	ipip
rtp	rtp
pcanywhere	pcanywhere
ssl	ssl
usenet	usenet
iax	iax
afp	afp
stealthnet	stealthnet
aimini	aimini
truphone	truphone
icmpv6	icmpv6
dhcpv6	dhcpv6
armagetron	armagetron
crossfire	crossfire
dofus	dofus
fiesta	fiesta
florensia	florensia
guildwars	guildwars
http_application_activesync	http_application_activesync
maplestory	maplestory
mssql	mssql
warcraft3	warcraft3
world_of_kung_fu	world_of_kung_fu
slack	slack
facebook	facebook
twitter	twitter
dropbox	dropbox
gmail	gmail
google_maps	google_maps
youtube	youtube
skype	skype
google	google
dcerpc	dcerpc
netflow	netflow
sflow	sflow
http_connect	http_connect
http_proxy	http_proxy
citrix	citrix
netflix	netflix
lastfm	lastfm
waze	waze
skyfile_prepaid	skyfile_prepaid
skyfile_rudics	skyfile_rudics
skyfile_postpaid	skyfile_postpaid
citrix_online	citrix_online
apple	apple
webex	webex
whatsapp	whatsapp
apple_icloud	apple_icloud
viber	viber
apple_itunes	apple_itunes
windows_update	windows_update
teamviewer	teamviewer
tuenti	tuenti
lotusnotes	lotusnotes
sap	sap
gtp	gtp
upnp	upnp
llmnr	llmnr
remotescan	remotescan
spotify	spotify
webm	webm
openvpn	openvpn
noe	noe
ciscovpn	ciscovpn
teamspeak	teamspeak
skinny	skinny
rtcp	rtcp
rsync	rsync
oracle	oracle
corba	corba
ubuntuone	ubuntuone
whois_das	whois_das
collectd	collectd
ms_lync	ms_lync
rtmp	rtmp
ftpdata	ftpdata
wikipedia	wikipedia
zmq	zmq
amazon	amazon
ebay	ebay
cnn	cnn
megaco	megaco
redis	redis
pando	pando
vhua	vhua
telegram	telegram
vevo	vevo
pandora	pandora
quic	quic
whatsapp_voice	whatsapp_voice
eaq	eaq
git	git
drda	drda
kakaotalk	kakaotalk
kakaotalk_voice	kakaotalk_voice
twitch	twitch
quickplay	quickplay
opendns	opendns
mpegts	mpegts
snapchat	snapchat
deezer	deezer
instagram	instagram
microsoft	microsoft
hotspot_shield	hotspot_shield
ocs	ocs
office_365	office_365
cloudflare	cloudflare
ms_one_drive	ms_one_drive
mqtt	mqtt
rx	rx
sina	sina
starcraft	starcraft
teredo	teredo
hep	hep
hangout	hangout
dpi_check	dpi_check
tor	tor
