tcp ALL_TCP
upd ALL_UDP
icmp  ALL_ICMP
ftp	FTP
pop	POP3
smtp	SMTP
imap	IMAP
dns	DNS
http	HTTP
ntp	NNTP
nfs	NFS
bgp	BGP
snmp	SNMP
smb	SMB
syslog	SYSLOG
dhcp	DHCP
mysql	MYSQL
smtps	SMTPS
mms	MMS
rtsp	RTSP
imaps	IMAPS
irc	IRC
msn	MSN
quake	QUAKE
telnet	TELNET
gre	GRE
ospf	OSPF
rdp	RDP
vnc	VNC
ssh	SSH
mgcp	MGCP
tftp	TFTP
sip	SIP
kerberos	KERBEROS
ldap	LDAP
pptp	PPTP
radius	RADIUS
h323	H323
socks	SOCKS
